3131313131333
1010101010133
3101010101013
1010101010101
3101010101013
1010101010101
3101010101013
1010101010101
3101010101013
1010101010101
3101010101013
3313131313133
