33333010333010333010333333333
33333101333101333101333333333
33333010333010333010333333333
33333333333333333333333333333
33333131313131313131313131333
01031010101010101010101010133
10133101010101010101010101013
01031010101010101010101010101
33333101010101010101010101013
33331010101010101010101010101
01033101010101010101010101013
10131010101010101010101010101
01033101010101010101010101013
33331010101010101010101010101
33333101010101010101010101013
01031010101010101010101010101
10133101010101010101010101013
01031010101010101010101010101
33333101010101010101010101013
33331010101010101010101010101
33333101010101010101010101013
33331010101010101010101010101
33333101010101010101010101013
33333010101010101010101010101
33333301010101010101010101013
33333333131313131313131313133
