3333301033301033301033333333333
3333310133310133310133333333333
3333301033301033301033333333333
3333333333333333333333333333333
3333313131313131313131313133333
0103101010101010101010101010133
1013310101010101010101010101013
0103101010101010101010101010101
3333310101010101010101010101013
3333101010101010101010101010101
0103310101010101010101010101013
1013101010101010101010101010101
0103310101010101010101010101013
3333101010101010101010101010101
3333310101010101010101010101013
0103101010101010101010101010101
1013310101010101010101010101013
0103101010101010101010101010101
3333310101010101010101010101013
3333101010101010101010101010101
3333310101010101010101010101013
3333101010101010101010101010101
3333310101010101010101010101013
3333101010101010101010101010101
3333310101010101010101010101013
3333301010101010101010101010101
3333330101010101010101010101013
3333333313131313131313131313133
